######################
#1            *      #
# @ @ @ @*   @ @ @ @ #
#  *  ** ***  **     #
# @ @*@ @    @ @ @ @ #
#**   *         ***  #
# @ @ @ @*b  @ @ @ @ #
#   *    *@@   *    *#
#   *     @@*  *b  * #
# @ @ @*@   *@ @ @*@ #
#     **      * *  * #
# @*@ @ @   *@ @*@ @ #
#  *b*     *      *  #
# @ @ @ @ *  @ @ @*@ #
#      *  *     *   2#
######################